3 4 3 4 73 84 92 92 92 85 3 4 3 4 3 4 3 4 3 4 3 4 3 4 3 4 3 4 3 4 60 61 61 61 61 61 61 61 61 61 61 61 61 61 61 61 61 61 61 59 
1 2 1 2 0 84 92 92 92 85 1 2 1 2 1 2 1 2 1 2 1 2 1 2 1 2 1 2 1 2 50 51 51 51 51 51 51 51 51 51 51 51 51 52 0 0 0 0 74 69 
67 50 51 51 51 81 77 77 77 78 51 51 51 51 51 51 51 51 52 72 0 0 0 0 0 71 0 0 3 4 53 137 136 137 135 137 136 137 135 137 136 137 137 55 0 0 0 0 0 69 
69 53 54 54 54 54 79 79 79 54 54 54 54 54 54 54 54 54 55 0 6 7 8 9 10 0 0 0 1 2 53 137 136 137 135 137 136 137 135 137 136 137 137 55 0 0 155 156 157 69 
63 56 57 57 57 82 80 80 80 83 57 57 57 57 57 57 96 54 55 0 5 13 14 15 11 0 75 0 3 4 53 137 136 137 135 137 136 137 135 137 136 137 137 55 0 0 158 159 160 69 
49 49 49 49 49 99 121 121 121 100 49 49 49 49 0 67 53 54 55 0 12 18 19 20 16 0 0 0 1 2 53 137 136 137 135 137 136 137 135 137 136 137 137 55 0 0 161 162 163 69 
32 32 32 32 32 101 122 122 122 104 32 32 32 32 46 69 53 54 55 0 17 23 93 25 21 0 0 0 3 4 53 137 137 137 137 137 137 137 137 137 137 137 137 55 0 0 0 0 71 69 
35 35 35 35 35 103 123 123 123 104 35 35 35 35 46 69 53 54 55 0 22 27 94 29 26 0 73 0 1 2 56 57 57 96 54 95 57 57 57 57 57 57 57 58 0 0 0 0 0 63 
38 38 38 38 38 105 124 124 124 106 38 38 38 38 46 69 53 54 55 0 0 53 54 55 3 4 3 4 3 4 0 0 0 53 54 55 0 67 111 49 49 49 49 49 49 49 49 49 49 49 
67 41 41 41 42 84 92 92 92 85 41 41 42 43 46 69 53 54 97 51 51 98 54 55 1 2 1 2 1 2 0 75 0 53 54 55 0 69 114 32 32 32 32 32 32 152 32 32 32 32 
69 50 51 51 52 84 92 92 92 85 0 72 0 0 46 69 53 54 54 54 54 54 54 55 0 0 0 0 0 0 0 0 0 53 54 97 52 69 114 31 31 31 31 31 31 153 31 31 31 31 
69 53 135 136 55 84 92 92 92 85 0 0 0 0 60 65 56 57 57 57 57 96 54 55 0 0 0 0 0 0 0 0 0 53 54 54 55 69 114 32 32 32 32 32 32 153 32 32 32 32 
69 53 135 136 55 84 92 92 92 85 0 0 0 0 0 74 0 0 0 0 0 53 54 51 51 52 0 0 73 0 0 0 0 56 96 54 55 69 114 38 38 38 38 38 38 154 38 38 38 38 
69 53 135 136 55 84 92 92 92 85 164 0 0 0 0 74 0 0 75 0 0 53 54 54 54 55 0 0 0 0 0 0 74 0 53 54 55 69 47 3 4 3 4 0 53 54 55 0 0 73 
69 53 135 136 55 84 92 92 92 85 0 0 0 0 60 61 59 0 0 0 0 56 57 96 54 97 51 51 51 51 51 51 51 51 98 54 55 69 47 1 2 1 2 0 53 54 55 0 3 4 
63 56 96 54 55 84 92 92 92 85 0 0 0 0 0 46 64 61 61 61 61 59 0 53 54 54 54 54 54 54 54 54 54 54 54 54 55 69 47 0 50 51 51 51 98 54 55 0 1 2 
3 4 53 54 55 84 92 92 92 149 140 0 71 0 110 115 116 116 116 116 52 69 0 0 57 57 57 57 57 57 57 57 57 57 57 57 58 69 114 0 53 54 54 54 54 54 55 0 3 4 
1 2 53 54 55 84 120 92 92 92 149 140 0 0 56 151 32 32 32 32 46 69 0 0 0 0 0 0 0 0 0 0 0 0 0 0 0 69 114 0 53 54 95 57 57 57 58 0 1 2 
3 4 53 54 55 86 87 148 92 92 92 149 140 0 0 151 35 35 35 35 112 64 61 61 61 61 61 61 61 61 61 61 61 61 61 61 61 65 114 0 53 54 55 0 0 0 0 0 3 4 
1 2 53 54 55 3 4 84 92 92 92 92 149 139 140 37 35 35 35 35 115 116 116 116 116 116 116 116 116 116 116 116 116 116 116 116 116 116 117 0 53 54 55 0 3 4 3 4 1 2 
3 4 53 54 55 1 2 86 148 92 92 92 92 92 85 73 42 42 42 43 151 32 32 32 32 32 32 32 32 32 32 32 32 32 32 32 32 32 32 0 53 54 55 0 1 2 1 2 0 67 
1 2 53 54 55 3 4 0 86 148 92 92 92 92 85 75 74 73 0 0 151 35 35 35 35 35 35 35 35 35 35 35 35 35 35 35 35 35 36 0 53 54 97 51 51 51 51 51 52 69 
3 4 53 54 55 1 2 3 4 84 92 92 92 92 149 140 75 73 75 0 151 31 31 31 31 31 31 31 31 31 31 31 31 31 31 31 31 31 36 0 53 54 54 54 54 54 54 54 55 69 
1 2 53 54 55 3 4 1 2 86 87 148 92 92 92 149 140 110 0 0 37 38 38 38 38 38 38 38 38 38 38 38 38 38 38 38 38 38 39 0 56 57 57 57 57 57 96 54 55 69 
3 4 53 54 55 1 2 3 4 3 4 84 92 92 92 92 149 140 0 0 40 42 42 42 42 42 42 42 42 42 42 41 41 41 41 41 41 41 43 3 4 3 4 3 4 0 53 54 55 69 
1 2 53 54 55 3 4 1 2 1 2 86 148 92 92 92 92 149 139 140 0 0 3 4 0 0 0 0 0 0 0 0 0 0 0 0 0 0 0 1 2 1 2 1 2 0 53 54 55 69 
67 0 53 54 55 1 2 3 4 3 4 0 84 92 92 92 92 92 92 149 140 0 1 2 50 51 51 51 51 51 51 51 51 51 51 51 51 51 51 51 51 51 51 51 51 51 98 54 55 69 
69 0 53 54 55 0 0 1 2 1 2 0 86 148 92 92 92 92 92 92 85 0 3 4 53 54 54 54 54 54 54 54 54 54 54 54 54 54 54 54 54 54 54 54 54 54 54 54 55 69 
69 0 53 54 55 0 0 3 4 3 4 3 4 86 148 92 92 92 92 92 85 0 1 2 53 54 95 57 57 57 57 57 57 57 57 57 57 57 57 96 54 95 57 57 57 57 57 57 58 63 
69 0 53 54 55 0 0 1 2 1 2 1 2 0 84 92 92 92 92 92 149 140 0 0 53 54 55 0 0 0 0 0 0 0 0 0 0 0 0 53 54 55 3 4 3 4 3 4 3 4 
69 0 53 54 55 0 0 0 0 0 0 3 4 0 86 87 148 92 92 92 92 149 140 0 53 54 55 0 3 4 3 4 3 4 3 4 3 4 0 53 54 55 1 2 1 2 1 2 1 2 
69 50 98 54 97 52 0 0 0 0 0 1 2 0 0 0 84 92 92 92 92 92 149 140 56 57 58 0 1 2 1 2 1 2 1 2 1 2 0 53 54 55 3 4 3 4 3 4 3 4 
69 53 54 54 54 97 51 51 51 51 51 51 51 51 51 0 86 148 77 77 77 77 77 85 0 110 0 0 0 0 0 3 4 3 4 3 4 3 4 53 54 55 1 2 1 2 1 2 1 2 
69 53 54 54 54 54 54 54 54 54 54 54 54 54 54 55 0 144 79 79 79 79 79 85 110 110 0 0 0 0 0 1 2 1 2 1 2 1 2 53 54 55 3 4 3 4 3 4 3 4 
69 53 54 54 54 95 57 57 57 57 57 57 57 57 57 0 0 0 80 80 80 80 80 149 139 139 140 0 0 0 0 0 0 3 4 0 0 0 0 53 54 55 1 2 1 2 1 2 1 2 
69 56 96 54 95 58 68 61 61 61 61 61 61 61 61 59 0 0 0 144 148 92 92 92 92 92 149 140 0 0 0 0 0 1 2 0 50 51 51 98 54 97 51 51 51 51 52 0 0 67 
69 0 53 54 55 0 69 0 6 7 8 9 10 0 0 69 0 0 0 0 144 148 92 92 92 92 92 149 140 0 0 0 0 3 4 0 53 137 137 137 137 137 137 137 137 137 55 0 0 69 
69 0 53 54 55 0 69 0 5 13 14 15 11 0 0 69 0 0 0 0 0 144 148 92 92 92 92 92 149 140 0 0 0 1 2 0 53 137 136 137 135 137 134 137 136 137 55 0 0 69 
69 0 53 54 55 0 69 0 12 18 19 20 16 0 0 69 60 61 61 61 61 62 144 145 148 92 92 92 92 149 139 140 0 3 4 0 53 137 136 137 135 137 134 137 136 137 55 0 0 69 
69 0 53 54 55 0 69 0 17 23 93 25 21 0 0 69 0 6 7 8 9 10 64 59 0 148 92 92 92 92 92 149 0 1 2 0 53 137 136 137 135 137 134 137 136 137 55 0 0 69 
69 0 53 54 55 0 69 0 22 27 94 29 26 0 0 69 0 5 13 14 15 11 0 64 59 144 148 92 92 92 92 92 149 139 140 0 53 137 137 137 137 137 137 137 137 137 55 0 73 69 
69 0 53 54 55 0 64 61 62 0 0 0 60 61 61 65 0 12 18 19 20 16 0 0 64 59 144 145 148 92 92 92 92 92 149 140 56 57 57 57 57 57 57 57 57 57 58 0 0 69 
69 0 53 54 97 51 51 51 51 51 51 51 51 51 51 51 52 17 25 93 23 21 0 0 0 64 59 0 144 148 92 92 92 92 92 149 140 0 0 0 0 0 0 0 0 0 0 0 0 69 
69 0 53 54 54 54 54 54 54 54 54 54 54 54 54 54 55 22 27 94 29 26 0 0 0 0 64 59 0 144 145 148 92 92 92 92 149 140 0 71 0 0 0 0 0 0 0 74 0 69 
69 0 56 57 57 57 57 57 57 57 57 57 57 57 96 54 55 0 0 0 0 0 0 0 0 0 0 64 61 61 61 61 148 92 92 92 92 149 140 0 0 0 0 75 0 0 0 0 0 69 
69 0 0 0 0 0 0 0 0 0 0 0 0 0 53 54 97 52 0 0 0 6 7 8 9 10 0 0 0 0 0 0 144 148 92 92 92 92 149 140 0 0 0 0 0 0 0 0 75 69 
69 0 0 0 0 0 0 0 0 0 0 0 0 0 53 54 54 55 0 0 0 5 13 14 15 11 0 0 0 0 0 0 0 0 148 92 92 92 92 149 140 0 0 0 0 0 164 0 0 69 
69 0 0 0 0 0 0 0 0 0 0 0 0 0 56 96 54 55 0 0 0 12 18 19 20 16 0 0 0 0 0 0 0 0 144 148 92 92 92 92 149 140 0 0 0 0 0 74 0 69 
69 0 0 0 0 0 0 0 0 0 0 0 0 0 0 53 54 55 0 0 0 17 23 93 25 21 0 0 0 0 0 0 0 0 0 144 148 92 92 92 92 149 140 0 0 0 0 0 0 69 
64 61 61 61 61 61 61 61 61 61 61 61 61 61 62 74 54 74 71 74 75 22 27 94 29 26 73 73 73 73 68 61 61 61 61 61 62 148 92 92 92 92 143 0 0 0 0 0 0 69 
